111111111111111
1000E0100000C01
100000000001001
111111100C01001
1000000P0010001

100000100001001
111000100000011
1C0C0010000C001
111111111111111
